-158.020959,21.443738,,,,,,
0.01652,,,,,,,
0,12,55,442,442,443,65,453
77,3,14,447,448,65,45,999
67,54,12,3,23,452,432,323
444,12,452,12,4,23,76,456
7,446,454,23,76,213,54,453
42,445,5,450,445,25,449,5
12,76,446,1,441,436,4,443
34,85,444,56,439,7,444,6
414,7,45,65,56,6,410,576
410,412,410,409,888,45,21,432
